1

a
111111111111
111111111111
111x  111111
111111111111
111111111111
1111111 x 11
111111111111
111111111111

2

a
111111111111
111111111111
111111111 x
111111111111
222222222222
22222222 x 2
222222222222
222222222222

3

a
222222222222
222222222222
222222222222
222222222xx
222222222222
222222222222
22 xx2222222
222222222222

4

a
222222222222
2 xx22222222
222222222222
222222 xx222
222222222222
333333333333
333333333333
3333 yy33333
333333333333

5

a
333333333333
333333 xx333
333333333333
333333 yy333
333333333333
33 xx3333333
333333333333
333333333333

6

a
333333333333
33333 x 3333
333333333333
333 x 333333
444444444444
444444444444
444444444444
4444444 x 44

7

a
444444444444
4444444 x 44
444444444444
4444 x 44444
444444444444
444444444444
 x 444444444
444444444444

8

a
444444444444
4444 x 4 x 4
444444444444
444444444444
555555555555
5 x 55555555
55555555 x 5
555555555555

9

a
55555555xx55
55xxx5555555
5555555xxx55
555555555555
55xxx5555xx5
555555555555
55555xxx5555
555555555xxx

10

a
111111111111
22xxx22xxx22
333333333333
4444xx444444
5555555xxxx5
555555555555
555 xx 55555
111111111111

11

a
xxxxxxxxxxxx
xxxxxxxxxxxx
xxxxxxxxxxxx
xxxxxxxxxxxx
xxxxxxxxxxxx
xxxxxxxxxxxx
xxxxxxxxxxxx
555555555555

12

a
555555555555
555555555555
55555x555x55
555555555555
66x66x666666
6666666666x6
666666x66666
666666666666

13

a
666666666666
6666x6666666
666666666x66
666666666666
6666x6x66666
666666666666
66666666666x
6666x6666666

14

a
666666666666
666666x66666
666666x66666
666666x66666
7777x7x7x777
777x x7x x77
777x x7x x77
7777x777x777

15

a
7yy777777777
777yyyy77777
777y777y7777
7777777y7777
77y7777y7777
77777yy7y777
777y77y7y777
777777777777

16

a
777777y77777
7777y777y777
777777y77777
777y77777777
888888888888
88y8888yy888
88888yy88888
888888888888

17
8888y8888888
88888888y888
88y88y888y88
88888y8888y8
88y8888yyy88
8888yyy88888
8yyy88888888
888888888888

18

a
888888yyy888
888yyy888888
888888888y88
yyy888y88888
999999yyy999
999999999999
999yyy999y99
999999999999

19

a
999999999999
999999999999
999999999999
999999999999
999999999999
999999999999
9zzzzzzzzzz9
999999999999

20

a
999999999999
9xxxxxxxxxx9
9xxxxxxxxxx9
9yyyyyyyyyy9
0yyyyyyyyyy0
000000000000
0zzzzzzzzzz0
000000000000


































































69

a
111111111111
2          2
3          3
4          4
5          5
12345      1
2  z       2
333333333333











































































