1
              
a            
111111111111
111111111111
111x  111111
111111111111
111111111111
1111111 x 11
111111111111
111111111111

2

a           
111111111111
111111111111
111111111 x 
111111111111
222222222222
22222222 x 2
222222222222
222222222222

3
            
a            
222222222222
222222222222
222222222222
222222222 x 
222222222222
222222222222
22 x 2222222
222222222222

4

a                    
222222222222
2 x 22222222
222222222222
222222 x 222
222222222222
333333333333
333333333333
3333 x 33333
333333333333

5

a
333333333333
333333 x 333
333333333333
333333 x 333
333333333333
33 x 3333333
333333333333
333333333333

5

a
333333333333
33333 x 3333
333333333333
333 x 333333
444444444444
444444444444
444444444444
4444444 x 44

6

a
444444444444
4444444 x 44
444444444444
4444 x 44444
444444444444
444444444444
 x 444444444
444444444444

7

a
444444444444
4444 x 4 x 4
444444444444
444444444444
555555555555
5 x 55555555
55555555 x 5
555555555555

8

a
55555555xx55
55xxx5555555
5555555xxx55
555555555555
55xxx5555xx5
555555555555
55555xxx5555
555555555xxx

9

a
111111111111
22xxx22xxx22
333333333333
4444xx444444
5555555xxxx5
555555555555
555 xx 55555
111111111111

10

a
xxxxxxxxxxxx
xxxxxxxxxxxx
xxxxxxxxxxxx
xxxxxxxxxxxx
xxxxxxxxxxxx
xxxxxxxxxxxx
xxxxxxxxxxxx
555555555555

11

a
111111111111
2          2
2          2
3          3
3    y     3
4          4
4x         4
555555555555
