1
              
 a            
111111111111
111111111111
111x  111111
111111111111
111111111111
1111111 x 11
111111111111
111111111111

2

a           
111111111111
111111111111
111111111 x 
111111111111
222222222222
22222222 x 2
222222222222
222222222222

3
            
            
222222222222
222222222222
222222222222
222222222 x 
222222222222
222222222222
22 x 2222222
222222222222

4
                        
222222222222
222222222222
222222222222
222222222222
222222222222
333333333333
333333333333
333333333333
333333333333

5


333333333333
333333333333
333333333333
333333333333
333333333333
333333333333
333333333333
333333333333
333333333333
333333333333

5


333333333333
333333333333
333333333333
333333333333




